E S E O E
O E E O E
O O E O O
E O E E O
O O E E F
